维护者：Senka
版本号：1.0.1
更新时间：2025-12-21

词条
// 主角
Byleth：贝雷丝
Sothis：苏谛斯
Claude：库罗德

// 教会
Rhea：蕾雅
Manuela Casagranda = 玛努艾拉·卡扎古蓝达
Hanneman von Essar = 汉尼曼·冯·艾萨
Seteth：西提司
Flayn：芙莲
Jeritza von Hrym = 伊艾里扎·冯·弗琉慕
Tomas：托马修
Cyril：锥里尔

// 骑士团
Jeralt Reus Eisner = 杰拉尔特·罗伊斯·艾斯纳
Catherine：卡多莉奴
Alois Rangeld = 阿罗伊斯·兰贾尔特
Gilbert Pronislav = 吉尔伯特·普罗尼斯拉夫
Shamir Nevrand = 萨米亚·聂芙兰特

// 黑鹫
Edelgard von Hresvelg = 艾黛尔贾特·冯·弗雷斯贝尔古
Hubert von Vestra = 修伯特·冯·贝斯特拉
Dorothea Arnault = 多洛缇雅·雅尔诺尔德
Ferdinand von Aegir = 菲尔迪南特·冯·艾吉尔
Bernadetta von Varley = 贝尔娜提塔·冯·瓦立
Caspar von Bergliez = 卡斯帕尔·冯·贝尔谷里斯
Petra Macneary = 佩托拉·马克聂阿利
Linhardt von Hevring = 林哈尔特·冯·海弗林格

// 青狮
Dimitri Alexandre Blaiddyd = 帝弥托利·亚历山大·布雷达德
Dedue Molinaro = 杜笃·莫利纳洛
Felix Hugo Fraldarius = 菲力克斯·尤果·伏拉鲁达力乌斯
Mercedes von Martritz = 梅尔赛德司·冯·马尔特利兹
Ashe Ubert = 亚修·多蓝
Annette Fantine Dominic = 雅妮特·方提努·多米尼克
Sylvain Jose Gautier = 希尔凡·乔瑟·戈迪耶
Ingrid Brandl Galatea = 英谷莉特·布兰多尔·贾拉提雅

// 金鹿
Claude von Riegan = 库罗德·冯·里刚
Hilda Valentine Goneril = 希尔妲·凡伦汀·哥纳利尔
Lorenz Hellman Gloucester = 洛廉兹·海尔曼·古罗斯塔尔
Raphael Kirsten = 拉斐尔·克里斯汀
Lysithea von Ordelia = 莉丝缇亚·冯·科迪利亚
Ignatz Victor = 伊古纳兹·维克特
Marianne von Edmund = 玛莉安奴·冯·艾德蒙
Leonie Pinelli = 雷欧妮·皮聂利

//灰狼
Yuri Leclerc = 尤里斯·路克雷
Constance von Nuvelle = 康丝坦洁·冯·努维尔
Balthus von Albrecht = 巴鲁塔札尔·冯·亚达尔布雷希特
Hapi：哈琵

//反派
Monica von Ochs = 莫妮卡·冯·奥克斯
Volkhard von Arundel = 佛尔克哈特·冯·亚兰德尔
Nemesis：涅梅希斯
Kostas：寇斯塔斯
Pallardó Davino = 巴迦尔德·达毕诺
Myson：谬森
Cornelia Arnim = 科尔娜莉亚·阿尔尼姆
